###########################################
#                                         #
#     ###############################     #
#     TTTTTTTTTTTTTTTTTTTTTTTTTTTTTTT     #
#     ###############################     #
#                                         #
#                                         #
#                                         #
#                                         #
#                                         #
#             #T#         #T#             #
#             #T#         #T#             #
#             #T#         #T#             #
#                                         #
#              s           s              #
#                                         #
#                                         #
#                                         #
#                                         #
#              s           s              #
#                                         #
#             #T#         #T#             #
#             #T#         #T#             #
#             #T#         #T#             #
#                                         #
#                                         #
#                                         #
#                                         #
#                                         #
#     ###############################     #
#     TTTTTTTTTTTTTTTTTTTTTTTTTTTTTTT     #
#     ###############################     #
#                                         #
###########################################