####################################################
#                                                  #
#                                                  #
#                                                  #
#                                                  #
#                                                  #
#                                                  #
#                                                  #
#                                                  #
#                                                  #
#                                                  #
#                                                  #
#                                                  #
#                                                  #
#                                                  #
#              s                   s               #
#                                                  #
#                                                  #
#                                                  #
#                                                  #
#                                                  #
#                                                  #
#                                                  #
#                                                  #
#                                                  #
#                                                  #
#                                                  #
#                                                  #
#                                                  #
#                                                  #
#                                                  #
#                                                  #
#                                                  #
#                                                  #
#                                                  #
#              s                   s               #
#                                                  #
#                                                  #
#                                                  #
#                                                  #
#                                                  #
#                                                  #
#                                                  #
#                                                  #
#                                                  #
#                                                  #
#                                                  #
#                                                  #
#                                                  #
#                                                  #
#                                                  #
####################################################
