###########################################
#                                         #
#                                         #
#                                         #
#                                         #
#            s               s            #
#        #       #       #       #        #
#        #       #       #       #        #
#        #       #       #       #        #
#        #       #       #       #        #
#        #       #       #       #        #
#        #       #       #       #        #
#        #       #       #       #        #
#        #       #       #       #        #
#        #       #       #       #        #
#        #       #       #       #        #
#        #       #       #       #        #
#        #       #       #       #        #
#        #       #       #       #        #
#        #       #       #       #        #
#        #       #       #       #        #
#        #       #       #       #        #
#        #       #       #       #        #
#        #       #       #       #        #
#        #       #       #       #        #
#        #       #       #       #        #
#        #       #       #       #        #
#        #       #       #       #        #
#           s                s            #
#                                         #
#                                         #
#                                         #
#                                         #
###########################################